	WE ./textures/WE.xpm
NO ./textures/NO.xpm
EA ./textures/EA.xpm





SO ./textures/SO.xpm

C 135,206,235

F 116,102,59



1111111111111111111111111111111111111111111111111111
1000000000000000000000000000000000000000000000000001
1000000000000000000000000000000000000000000000000001
1000000000000000000000000000000000000000000000000001
1000000000000000000000000000000000000000000000000001
1000000000000000000000000000000000000000000000000001
1000000000000011100011110001111000111000000000000001
1000000000000000100000010000001000001000000000000001
1000000000000000100011110001111000001000000000000001
1000000000000000100000010000001000001000000000000001
1000000000000011110011110001111000001000000000000001
10000000000000000000000000000000000000000000000000011111
1000000000000000000000000000000000000000000000000000000N1
11111111111111111111111111111111111111111111111111111111